{
    "id": 1,
    "fechaCreacion": "1994-10-01",
    "fechaFin": "2017-10-01",
    "fechas": [
        "1994-10-01",
        "1995-01-01",
        "1995-02-01",
        "1995-04-01",
        "1995-05-01",
        "1996-01-01",
        "1996-05-01",
        "1996-06-01",
        "1996-09-01",
        "1997-01-01",
        "1997-03-01",
        "1997-07-01",
        "1997-09-01",
        "1997-10-01",
        "1997-12-01",
        "1998-01-01",
        "1998-03-01",
        "1998-10-01",
        "1999-01-01",
        "1999-06-01",
        "1999-07-01",
        "1999-11-01",
        "1999-12-01",
        "2000-01-01",
        "2000-04-01",
        "2000-07-01",
        "2000-09-01",
        "2000-10-01",
        "2000-11-01",
        "2001-02-01",
        "2001-04-01",
        "2001-06-01",
        "2001-10-01",
        "2001-11-01",
        "2002-01-01",
        "2002-05-01",
        "2002-07-01",
        "2002-12-01",
        "2003-01-01",
        "2003-02-01",
        "2003-03-01",
        "2003-09-01",
        "2003-12-01",
        "2004-01-01",
        "2004-08-01",
        "2004-10-01",
        "2005-01-01",
        "2005-02-01",
        "2005-03-01",
        "2005-07-01",
        "2005-09-01",
        "2005-12-01",
        "2006-01-01",
        "2006-03-01",
        "2006-10-01",
        "2006-11-01",
        "2007-03-01",
        "2007-06-01",
        "2007-08-01",
        "2007-10-01",
        "2008-05-01",
        "2008-09-01",
        "2008-11-01",
        "2009-01-01",
        "2009-02-01",
        "2009-03-01",
        "2009-05-01",
        "2009-08-01",
        "2009-09-01",
        "2009-10-01",
        "2009-11-01",
        "2010-05-01",
        "2010-09-01",
        "2010-10-01",
        "2011-01-01",
        "2011-05-01",
        "2011-06-01",
        "2011-11-01",
        "2012-01-01",
        "2012-05-01",
        "2012-08-01",
        "2012-09-01",
        "2013-01-01",
        "2013-11-01",
        "2013-12-01",
        "2014-01-01",
        "2014-02-01",
        "2014-10-01",
        "2014-12-01",
        "2015-03-01",
        "2015-09-01",
        "2016-04-01",
        "2017-01-01",
        "2017-05-01",
        "2017-09-01"
    ]
}